"aD" = (/turf/closed/indestructible/reinforced,/area/deathmatch)
"aP" = (/obj/machinery/door/airlock/centcom{req_access_txt = "201"},/turf/open/space/basic,/area/deathmatch)
"bI" = (/obj/machinery/light/no_nightlight/directional/north,/turf/open/indestructible,/area/deathmatch)
"cn" = (/turf/open/indestructible,/area/deathmatch)
"cx" = (/obj/machinery/vending/wallmed/directional/north,/turf/open/indestructible,/area/deathmatch)
"cy" = (/obj/structure/table/reinforced/ctf,/obj/item/gun/ballistic/shotgun/riot,/turf/open/indestructible,/area/deathmatch)
"eX" = (/obj/item/ammo_casing/shotgun/frag12,/turf/open/indestructible,/area/deathmatch)
"fh" = (/obj/structure/table/reinforced/ctf,/obj/item/storage/backpack/duffelbag/syndie/ammo/shotgun,/turf/open/indestructible,/area/deathmatch)
"ga" = (/obj/structure/lattice,/turf/open/space/basic,/area/template_noop)
"gJ" = (/obj/item/ammo_casing/shotgun/stunslug,/turf/open/indestructible,/area/deathmatch)
"ho" = (/obj/effect/spawner/structure/window/reinforced/indestructable,/turf/open/floor/plating,/area/deathmatch)
"hB" = (/turf/closed/indestructible/fakedoor,/area/deathmatch)
"hN" = (/obj/structure/lattice,/obj/effect/decal/cleanable/dirt/dust,/turf/open/space/basic,/area/template_noop)
"ih" = (/obj/item/reagent_containers/pill/maintenance,/turf/open/indestructible,/area/deathmatch)
"iC" = (/obj/structure/table/reinforced/ctf,/obj/machinery/light/small/directional/south,/turf/open/indestructible,/area/deathmatch)
"jc" = (/obj/effect/decal/cleanable/dirt/dust,/turf/open/indestructible,/area/deathmatch)
"jX" = (/obj/machinery/light/small/directional/north,/turf/open/indestructible,/area/deathmatch)
"jY" = (/obj/item/stack/medical/gauze{amount = 1},/turf/open/indestructible,/area/deathmatch)
"ka" = (/obj/effect/decal/cleanable/blood/old,/turf/open/indestructible,/area/deathmatch)
"kp" = (/obj/effect/turf_decal/stripes/corner{dir = 4},/turf/open/indestructible,/area/deathmatch)
"kx" = (/obj/effect/decal/cleanable/dirt,/obj/effect/turf_decal/stripes/line{dir = 1},/obj/effect/landmark/deathmatch_player_spawn,/turf/open/indestructible,/area/deathmatch)
"lA" = (/obj/effect/turf_decal/stripes/corner{dir = 1},/turf/open/indestructible,/area/deathmatch)
"lJ" = (/obj/structure/table/reinforced/ctf,/obj/item/crowbar,/turf/open/indestructible,/area/deathmatch)
"lN" = (/obj/effect/decal/cleanable/dirt/dust,/obj/effect/turf_decal/caution/stand_clear,/turf/open/indestructible,/area/deathmatch)
"mS" = (/obj/effect/turf_decal/caution/stand_clear,/turf/open/indestructible,/area/deathmatch)
"mZ" = (/obj/structure/grille,/turf/open/indestructible,/area/deathmatch)
"nQ" = (/obj/effect/decal/cleanable/dirt,/turf/open/indestructible,/area/deathmatch)
"nS" = (/obj/machinery/light/small/directional/north,/obj/effect/decal/cleanable/dirt/dust,/obj/effect/decal/cleanable/blood/gibs/old,/turf/open/indestructible,/area/deathmatch)
"pT" = (/obj/structure/rack,/obj/item/grenade/chem_grenade/cleaner,/turf/open/indestructible,/area/deathmatch)
"pZ" = (/obj/structure/sign/poster/random{pixel_x = -32},/turf/open/indestructible,/area/deathmatch)
"qK" = (/obj/effect/decal/cleanable/dirt,/obj/item/reagent_containers/pill/maintenance,/turf/open/indestructible,/area/deathmatch)
"sk" = (/obj/structure/sign/poster/random{pixel_x = 32},/turf/open/indestructible,/area/deathmatch)
"sl" = (/obj/machinery/door/airlock/public/glass,/obj/effect/mapping_helpers/airlock/abandoned,/turf/open/indestructible,/area/deathmatch)
"sF" = (/obj/structure/extinguisher_cabinet/directional/east,/obj/structure/closet/firecloset,/obj/effect/turf_decal/delivery,/turf/open/indestructible,/area/deathmatch)
"sV" = (/obj/structure/closet/emcloset,/obj/effect/turf_decal/delivery,/turf/open/indestructible,/area/deathmatch)
"sX" = (/obj/structure/rack,/obj/machinery/light/small/directional/north,/obj/item/reagent_containers/food/drinks/soda_cans/lemon_lime,/turf/open/indestructible,/area/deathmatch)
"tT" = (/obj/structure/rack,/obj/item/stack/cable_coil,/obj/item/assembly/igniter,/turf/open/indestructible,/area/deathmatch)
"vB" = (/obj/machinery/light/small/directional/east,/turf/open/indestructible,/area/deathmatch)
"wi" = (/obj/structure/table/reinforced/ctf,/obj/item/screwdriver,/turf/open/indestructible,/area/deathmatch)
"wC" = (/obj/item/weldingtool,/obj/structure/rack,/obj/item/flashlight/flare,/turf/open/indestructible,/area/deathmatch)
"zd" = (/obj/machinery/vending/medical{desc = "Go on, smash this vending machine. You want free healing right? Do it."},/turf/open/indestructible,/area/deathmatch)
"zF" = (/obj/item/ammo_casing/shotgun/improvised,/turf/open/indestructible,/area/deathmatch)
"AG" = (/obj/structure/lattice/catwalk,/obj/item/storage/toolbox/mechanical/old/clean{desc = "An old, blue toolbox, it looks soulful."},/turf/open/space/basic,/area/template_noop)
"Bs" = (/obj/machinery/light/small/directional/west,/obj/effect/decal/cleanable/dirt,/turf/open/indestructible,/area/deathmatch)
"BU" = (/obj/item/chainsaw,/turf/open/indestructible,/area/deathmatch)
"BV" = (/obj/structure/table/reinforced/ctf,/turf/open/indestructible,/area/deathmatch)
"Dh" = (/obj/structure/cable,/obj/machinery/power/apc/auto_name/east,/turf/open/indestructible,/area/deathmatch)
"Dt" = (/obj/effect/decal/cleanable/dirt,/obj/effect/turf_decal/loading_area{dir = 4},/turf/open/indestructible,/area/deathmatch)
"Er" = (/obj/structure/table/reinforced/ctf,/obj/item/clothing/head/welding,/turf/open/indestructible,/area/deathmatch)
"Ew" = (/obj/effect/decal/cleanable/dirt/dust,/obj/item/reagent_containers/pill/maintenance,/turf/open/indestructible,/area/deathmatch)
"EK" = (/obj/machinery/light/small/directional/south,/turf/open/indestructible,/area/deathmatch)
"EN" = (/obj/structure/reagent_dispensers/fueltank,/obj/effect/turf_decal/bot,/turf/open/indestructible,/area/deathmatch)
"EW" = (/obj/effect/decal/cleanable/blood/tracks,/obj/effect/landmark/deathmatch_player_spawn,/turf/open/indestructible,/area/deathmatch)
"Fp" = (/obj/structure/rack,/obj/item/reagent_containers/pill/maintenance,/obj/item/spear,/turf/open/indestructible,/area/deathmatch)
"FH" = (/obj/effect/decal/cleanable/oil/slippery,/turf/open/indestructible,/area/deathmatch)
"Gi" = (/obj/effect/decal/cleanable/blood/gibs/limb,/turf/open/indestructible,/area/deathmatch)
"GA" = (/obj/item/stack/medical/mesh{amount = 4},/obj/item/spear,/obj/structure/closet/emcloset,/obj/effect/turf_decal/delivery,/turf/open/indestructible,/area/deathmatch)
"GF" = (/obj/machinery/light/small/directional/west,/turf/open/indestructible,/area/deathmatch)
"Hd" = (/obj/structure/table/reinforced/ctf,/obj/machinery/light/small/directional/north,/obj/item/soap/nanotrasen,/turf/open/indestructible,/area/deathmatch)
"Hp" = (/obj/structure/table/reinforced/ctf,/obj/item/reagent_containers/pill/maintenance,/obj/structure/sign/poster/random{pixel_y = 32},/turf/open/indestructible,/area/deathmatch)
"HE" = (/obj/structure/lattice/catwalk,/obj/structure/statue/sandstone/assistant,/turf/open/space/basic,/area/template_noop)
"Ij" = (/turf/open/space/basic,/area/template_noop)
"It" = (/obj/item/gun/ballistic/rifle/boltaction/pipegun/prime,/obj/effect/turf_decal/box,/turf/open/indestructible,/area/deathmatch)
"Kt" = (/obj/structure/table/reinforced/ctf,/obj/item/weldingtool,/turf/open/indestructible,/area/deathmatch)
"KW" = (/obj/machinery/space_heater,/obj/effect/turf_decal/bot,/turf/open/indestructible,/area/deathmatch)
"La" = (/obj/structure/table/reinforced/ctf,/obj/structure/sign/poster/random{pixel_y = -32},/obj/item/flashlight/flare,/turf/open/indestructible,/area/deathmatch)
"LJ" = (/obj/structure/reagent_dispensers/watertank,/obj/effect/turf_decal/bot,/turf/open/indestructible,/area/deathmatch)
"Mt" = (/obj/effect/landmark/deathmatch_player_spawn,/turf/open/indestructible,/area/deathmatch)
"MC" = (/obj/effect/mob_spawn/human/corpse/assistant,/turf/open/space/basic,/area/template_noop)
"Na" = (/obj/structure/rack,/obj/item/reagent_containers/food/drinks/soda_cans/starkist,/turf/open/indestructible,/area/deathmatch)
"Ns" = (/obj/structure/table/reinforced/ctf,/obj/item/stack/cable_coil,/turf/open/indestructible,/area/deathmatch)
"NO" = (/obj/structure/extinguisher_cabinet/directional/west,/turf/open/indestructible,/area/deathmatch)
"NU" = (/obj/effect/decal/cleanable/blood,/turf/open/indestructible,/area/deathmatch)
"NY" = (/obj/item/screwdriver,/turf/open/indestructible,/area/deathmatch)
"Ok" = (/obj/structure/extinguisher_cabinet/directional/south,/obj/machinery/light/small/directional/south,/turf/open/indestructible,/area/deathmatch)
"Om" = (/obj/effect/decal/cleanable/dirt,/obj/structure/sign/poster/random{pixel_y = -32},/turf/open/indestructible,/area/deathmatch)
"OA" = (/obj/effect/decal/cleanable/blood/tracks,/turf/open/indestructible,/area/deathmatch)
"OO" = (/obj/effect/decal/cleanable/dirt,/obj/effect/decal/cleanable/blood/tracks,/obj/structure/sign/poster/random{pixel_x = 32},/turf/open/indestructible,/area/deathmatch)
"OR" = (/obj/item/stack/medical/suture{amount = 6},/turf/open/indestructible,/area/deathmatch)
"Pp" = (/obj/machinery/light/small/directional/south,/obj/effect/decal/cleanable/dirt,/turf/open/indestructible,/area/deathmatch)
"PW" = (/obj/effect/decal/cleanable/blood/gibs/torso,/turf/open/indestructible,/area/deathmatch)
"Qr" = (/obj/structure/closet/wardrobe,/turf/open/floor/plating{icon_state = "platingdmg1"},/area/template_noop)
"Qs" = (/obj/structure/lattice,/obj/structure/lattice,/turf/open/space/basic,/area/template_noop)
"QN" = (/obj/structure/table/reinforced/ctf,/obj/item/razor,/turf/open/indestructible,/area/deathmatch)
"QQ" = (/obj/effect/decal/cleanable/blood/drip,/obj/effect/turf_decal/box,/turf/open/indestructible,/area/deathmatch)
"Rm" = (/obj/item/weldingtool,/obj/structure/rack,/turf/open/indestructible,/area/deathmatch)
"Su" = (/obj/effect/decal/cleanable/dirt/dust,/obj/effect/turf_decal/box,/obj/effect/landmark/deathmatch_player_spawn,/turf/open/indestructible,/area/deathmatch)
"SN" = (/obj/effect/decal/cleanable/blood/tracks,/obj/effect/turf_decal/caution/stand_clear,/turf/open/indestructible,/area/deathmatch)
"Tu" = (/obj/structure/table/reinforced/ctf,/obj/machinery/light/small/directional/north,/turf/open/indestructible,/area/deathmatch)
"TB" = (/obj/structure/closet/firecloset,/obj/effect/turf_decal/delivery,/turf/open/indestructible,/area/deathmatch)
"TP" = (/obj/effect/mapping_helpers/airlock/abandoned,/obj/machinery/door/airlock/public/glass,/turf/open/indestructible,/area/deathmatch)
"Un" = (/obj/effect/decal/cleanable/dirt,/obj/effect/decal/cleanable/blood/tracks{dir = 10},/obj/effect/turf_decal/stripes/corner,/turf/open/indestructible,/area/deathmatch)
"Vb" = (/obj/effect/decal/cleanable/blood/tracks{dir = 5},/obj/effect/turf_decal/stripes/line,/turf/open/indestructible,/area/deathmatch)
"Xb" = (/obj/effect/turf_decal/stripes/corner{dir = 8},/turf/open/indestructible,/area/deathmatch)
"XC" = (/obj/item/assembly/igniter,/turf/open/indestructible,/area/deathmatch)
"XD" = (/obj/item/holosign_creator/security,/obj/machinery/light/small/directional/south,/turf/open/indestructible,/area/deathmatch)
"Yd" = (/obj/machinery/power/smes/magical,/turf/open/indestructible,/area/deathmatch)
"Zu" = (/obj/structure/cable,/obj/machinery/power/terminal{dir = 8},/turf/open/indestructible,/area/deathmatch)

(1,1,1) = {"
IjIjIjIjIjIjIjIjIjIjIjaDaDaPaDaDaDaPaDaDIjIjIjIjIjIjIjIjIjIjIjIjIj
IjIjIjIjIjIjIjIjIjIjIjaDbIcncncxcncnbIaDIjIjIjIjIjIjIjIjIjIjIjIjIj
IjIjIjIjIjIjIjIjIjIjIjaDcycncncneXcnfhaDIjIjIjIjIjIjIjIjIjIjIjIjIj
IjIjIjIjIjIjIjIjIjIjIjaDcycncncncncnfhaDIjIjIjIjIjIjIjIjIjIjIjIjIj
IjgaIjIjIjIjIjIjIjIjIjaDcngJcncncncncnaDIjIjIjIjgaIjIjgaIjIjIjIjIj
gagagagaaDaDaDaDaDaDaDaDhohoaDhBaDhohoaDaDgagagagagagagagaIjIjIjIj
IjhNIjIjaDcniCcnhoEwcnjXjYkakpkxlAcncnlJaDIjIjIjgaIjIjgaIjIjIjIjIj
IjgaIjIjaDlNaDmSaDmSaDaDhoaDaDmZaDaDcnaDaDaDaDaDaDhohoaDIjIjIjIjIj
IjgaIjIjaDcnaDnQaDMtaDIjIjIjaDcnihcncnnQcncncnnScncnpTaDIjIjIjIjIj
IjgaIjIjaDpZaDcnaDnQaDIjIjIjaDskaDaDhBaDaDslaDaDaDcnsFaDaDaDaDaDIj
gagagagaaDnQaDcnsXskaDIjIjIjaDcntTaDvBaDMtcnjXwiaDpZMtcnwCzdmZaDIj
IjgaIjIjhozFaDcncncnaDgaAGgaaDBscnaDBUBVDtcncnEraDnQmZcnEKnQcnhoIj
IjgaIjIjhozFaDcnENmZaDIjIjIjaDcnENaDFpaDcnFHcnGiaDcnaDaDaDaDcnhoIj
IjgaIjIjhozFBVcnmZGAaDIjIjIjaDcnaDaDaDaDaDGFnQcnslcnaDHdHpENjchoIj
IjHEIjIjhoItlJjcENmZaDIjIjIjaDcnaDsVKtKWaDLaLJNaaDcnmZnQcncncnaDIj
IjgaIjIjhozFNscncncnaDaDhoaDaDpZaDGFcncnaDaDmZaDaDcnaDcnaDhoaDaDIj
IjgaIjIjhozFaDNOEKNUnQNYOkjccncncncnOmcncncnMtjXcncnaDcnaDIjIjgaIj
IjgaIjIjhozFaDcnaDOAaDaDaDaDaDcnaDaDaDhohoaDaDjcaDaDaDcnhoIjIjgaIj
gagagagaaDjcaDcnaDOOaDTBjXjYslnQENaDIjgaIjIjaDjcslORPpcnaDIjIjgaIj
IjgaIjIjaDcnaDnQmZEWhocnjcPWaDcncnhogaQrIjIjhocnaDaDaDhoaDgagaQsga
IjgaIjIjaDskaDcnaDOAhocncnnQQNQQcnhoIjgagagahoqKaDIjIjIjIjIjIjgaIj
IjgaIjIjaDnQaDihaDOAaDRmEKcnBVSucnaDIjIjgaIjaDcnaDIjIjIjIjIjIjgaIj
IjgaIjIjaDmSaDmSaDSNaDaDaDaDaDaDcnaDaDhohoaDaDskaDIjIjIjIjIjIjgaIj
IjgaIjIjaDcnTucnTPUnVbXbjcjXihcnnQMtmZcnnQXCcnXDaDgagagagagagagaga
gagagagaaDaDaDaDaDaDhBaDaDaDaDaDaDaDaDhohoaDaDaDaDIjIjIjIjIjIjgaIj
IjgaIjIjIjIjIjIjaDYdZuDhaDIjIjIjgaIjIjIjIjIjIjgaIjIjIjIjIjIjIjgaIj
IjIjIjIjIjIjIjIjaDcnEKcnaDIjIjIjgaIjIjIjIjIjIjgaIjIjIjIjIjIjIjgaIj
IjIjIjIjIjIjIjIjaDaDaDaDaDIjIjgagagagagagagagagagagagagagagagaQsga
IjIjIjIjIjIjIjIjIjIjIjIjIjIjIjIjgaIjIjIjMCIjIjgaIjIjIjIjIjIjIjgaIj
"}
