"ac" = (/obj/structure/closet/crate/medical,/turf/open/space/basic,/area/template_noop)
"ae" = (/obj/effect/mob_spawn/human/corpse/cargo_tech,/turf/open/space/basic,/area/template_noop)
"ai" = (/turf/closed/indestructible/reinforced,/area/deathmatch)
"aE" = (/turf/closed/indestructible/fakedoor,/area/deathmatch)
"bl" = (/turf/closed/indestructible/fakeglass,/area/deathmatch)
"bW" = (/obj/structure/closet/secure_closet/engineering_welding,/turf/open/indestructible,/area/deathmatch)
"cA" = (/turf/open/indestructible,/area/deathmatch)
"cR" = (/obj/machinery/field/generator/anchored,/obj/effect/turf_decal/bot,/turf/open/indestructible,/area/deathmatch)
"cY" = (/obj/machinery/power/emitter/ctf{dir = 1},/obj/effect/turf_decal/bot,/obj/structure/cable,/turf/open/indestructible,/area/deathmatch)
"do" = (/obj/effect/turf_decal/stripes/line,/turf/open/indestructible,/area/deathmatch)
"dt" = (/obj/machinery/light/no_nightlight/directional/north,/obj/effect/turf_decal/stripes/line,/turf/open/indestructible,/area/deathmatch)
"dy" = (/obj/structure/sign/poster/official/random{pixel_y = 32},/obj/effect/turf_decal/stripes/line,/turf/open/indestructible,/area/deathmatch)
"er" = (/obj/structure/disposalpipe/segment{dir = 6},/turf/closed/indestructible/reinforced,/area/deathmatch)
"fH" = (/obj/machinery/light/no_nightlight/directional/east,/turf/open/indestructible,/area/deathmatch)
"fN" = (/obj/structure/sign/directions/engineering,/turf/closed/indestructible/reinforced,/area/deathmatch)
"fV" = (/obj/structure/particle_accelerator/end_cap,/turf/open/indestructible,/area/deathmatch)
"gd" = (/obj/machinery/power/grounding_rod,/turf/open/indestructible,/area/deathmatch)
"go" = (/obj/machinery/power/grounding_rod,/obj/machinery/light/red/directional/east,/turf/open/indestructible,/area/deathmatch)
"gC" = (/obj/machinery/power/emitter/ctf,/obj/effect/turf_decal/bot,/obj/structure/cable,/turf/open/indestructible,/area/deathmatch)
"gG" = (/obj/structure/cable,/obj/structure/cable,/obj/structure/extinguisher_cabinet/directional/west,/turf/open/indestructible,/area/deathmatch)
"gN" = (/obj/structure/cable,/turf/open/indestructible,/area/deathmatch)
"gU" = (/obj/structure/cable,/obj/machinery/conveyor/auto{dir = 5; verted = -1},/turf/open/indestructible,/area/deathmatch)
"hj" = (/obj/machinery/conveyor/auto{dir = 8},/obj/structure/cable,/turf/open/indestructible,/area/deathmatch)
"hR" = (/obj/structure/cable,/obj/machinery/conveyor/auto{dir = 6; verted = -1},/turf/open/indestructible,/area/deathmatch)
"hU" = (/obj/machinery/light/no_nightlight/directional/east,/obj/structure/cable,/turf/open/indestructible,/area/deathmatch)
"ig" = (/obj/structure/cable,/obj/effect/turf_decal/delivery,/turf/open/indestructible,/area/deathmatch)
"ih" = (/obj/structure/cable,/obj/structure/cable,/turf/open/indestructible,/area/deathmatch)
"iE" = (/obj/structure/cable,/obj/effect/turf_decal/loading_area,/turf/open/indestructible,/area/deathmatch)
"iP" = (/obj/structure/cable,/obj/structure/cable,/obj/structure/extinguisher_cabinet/directional/east,/turf/open/indestructible,/area/deathmatch)
"je" = (/turf/open/space/basic,/area/template_noop)
"jf" = (/obj/machinery/particle_accelerator/control_box,/turf/open/indestructible,/area/deathmatch)
"jn" = (/obj/structure/particle_accelerator/fuel_chamber,/turf/open/indestructible,/area/deathmatch)
"jC" = (/obj/machinery/the_singularitygen/tesla,/turf/open/indestructible,/area/deathmatch)
"kh" = (/obj/structure/closet/secure_closet/engineering_electrical,/turf/open/indestructible,/area/deathmatch)
"kB" = (/obj/effect/landmark/deathmatch_player_spawn,/turf/open/indestructible,/area/deathmatch)
"kP" = (/obj/machinery/conveyor/auto,/turf/open/indestructible,/area/deathmatch)
"lh" = (/obj/machinery/conveyor/auto{dir = 5; verted = -1},/turf/open/indestructible,/area/deathmatch)
"lu" = (/obj/machinery/conveyor/auto{dir = 8},/turf/open/indestructible,/area/deathmatch)
"ly" = (/obj/machinery/conveyor/auto{dir = 6; verted = -1},/turf/open/indestructible,/area/deathmatch)
"lU" = (/obj/machinery/conveyor/auto{dir = 1},/turf/open/indestructible,/area/deathmatch)
"mg" = (/obj/effect/turf_decal/delivery,/turf/open/indestructible,/area/deathmatch)
"mj" = (/obj/structure/reagent_dispensers/fueltank,/turf/open/indestructible,/area/deathmatch)
"mw" = (/obj/machinery/conveyor/auto{dir = 8},/obj/structure/closet,/obj/item/soap/nanotrasen,/turf/open/indestructible,/area/deathmatch)
"mK" = (/obj/effect/landmark/deathmatch_player_spawn,/obj/machinery/conveyor/auto{dir = 6; verted = -1},/turf/open/indestructible,/area/deathmatch)
"mO" = (/obj/structure/particle_accelerator/power_box,/turf/open/indestructible,/area/deathmatch)
"np" = (/obj/structure/reflector/double/mapping{dir = 6},/obj/effect/turf_decal/bot/left,/turf/open/indestructible,/area/deathmatch)
"nV" = (/obj/item/stack/cable_coil,/turf/open/indestructible,/area/deathmatch)
"or" = (/obj/machinery/conveyor/auto,/obj/structure/closet/firecloset,/turf/open/indestructible,/area/deathmatch)
"oT" = (/obj/effect/spawner/structure/window/plasma/reinforced,/turf/open/indestructible,/area/deathmatch)
"pe" = (/obj/machinery/conveyor/auto{dir = 1},/obj/item/clothing/glasses/meson/engine/tray,/turf/open/indestructible,/area/deathmatch)
"pf" = (/obj/structure/reflector/single/mapping{dir = 10},/obj/effect/turf_decal/bot/left,/turf/open/indestructible,/area/deathmatch)
"pO" = (/obj/structure/table/reinforced,/obj/item/assembly/prox_sensor,/turf/open/indestructible,/area/deathmatch)
"qn" = (/obj/structure/reflector/single/mapping{dir = 6},/obj/effect/turf_decal/bot/left,/turf/open/indestructible,/area/deathmatch)
"qo" = (/obj/structure/cable,/obj/effect/turf_decal/caution/stand_clear,/turf/open/indestructible,/area/deathmatch)
"rz" = (/obj/machinery/power/emitter/ctf{dir = 8},/obj/effect/turf_decal/bot,/obj/structure/cable,/turf/open/indestructible,/area/deathmatch)
"rL" = (/obj/structure/particle_accelerator/particle_emitter/left,/turf/open/indestructible,/area/deathmatch)
"sa" = (/obj/structure/particle_accelerator/particle_emitter/center,/turf/open/indestructible,/area/deathmatch)
"sb" = (/obj/structure/particle_accelerator/particle_emitter/right,/turf/open/indestructible,/area/deathmatch)
"sp" = (/obj/structure/cable,/obj/effect/turf_decal/stripes/corner{dir = 8},/turf/open/indestructible,/area/deathmatch)
"sx" = (/obj/item/clothing/suit/hazardvest,/turf/open/indestructible,/area/deathmatch)
"sP" = (/obj/item/stack/rods/fifty,/obj/structure/rack,/turf/open/indestructible,/area/deathmatch)
"sX" = (/obj/machinery/conveyor/auto,/obj/item/stack/sheet/cardboard,/turf/open/indestructible,/area/deathmatch)
"sZ" = (/obj/structure/cable,/obj/effect/landmark/deathmatch_player_spawn,/turf/open/indestructible,/area/deathmatch)
"ta" = (/obj/structure/table/reinforced,/obj/item/clothing/head/welding,/turf/open/indestructible,/area/deathmatch)
"tc" = (/obj/machinery/light/red/directional/west,/turf/open/indestructible,/area/deathmatch)
"th" = (/obj/structure/cable,/obj/effect/turf_decal/stripes/line{dir = 8},/turf/open/indestructible,/area/deathmatch)
"tT" = (/obj/structure/disposalpipe/trunk{dir = 2},/obj/structure/disposaloutlet{dir = 1},/turf/open/indestructible,/area/deathmatch)
"tU" = (/obj/item/storage/toolbox/drone{pixel_y = 5},/obj/item/storage/toolbox/electrical,/obj/structure/rack,/obj/item/crowbar,/turf/open/indestructible,/area/deathmatch)
"ub" = (/obj/machinery/conveyor/auto{dir = 1},/obj/machinery/light/no_nightlight/directional/west,/turf/open/indestructible,/area/deathmatch)
"uv" = (/obj/structure/table/reinforced,/obj/item/weldingtool/largetank,/turf/open/indestructible,/area/deathmatch)
"uY" = (/obj/structure/closet/crate/engineering,/turf/open/indestructible,/area/deathmatch)
"vD" = (/obj/machinery/power/tesla_coil,/turf/open/indestructible,/area/deathmatch)
"vG" = (/obj/item/tank/internals/plasma/full,/obj/structure/rack,/turf/open/indestructible,/area/deathmatch)
"vK" = (/obj/structure/cable,/obj/effect/turf_decal/stripes/corner{dir = 1},/turf/open/indestructible,/area/deathmatch)
"vT" = (/obj/effect/turf_decal/stripes/corner,/turf/open/indestructible,/area/deathmatch)
"wb" = (/obj/effect/turf_decal/stripes/line,/obj/structure/disposalpipe/segment{dir = 5},/turf/open/indestructible,/area/deathmatch)
"wd" = (/obj/machinery/power/rad_collector/anchored,/obj/effect/turf_decal/stripes/line,/obj/structure/disposalpipe/segment{dir = 4},/turf/open/indestructible,/area/deathmatch)
"wy" = (/obj/effect/turf_decal/stripes/line,/obj/structure/disposalpipe/segment{dir = 4},/turf/open/indestructible,/area/deathmatch)
"wI" = (/obj/effect/turf_decal/stripes/corner{dir = 8},/obj/structure/disposalpipe/segment{dir = 4},/turf/open/indestructible,/area/deathmatch)
"wK" = (/obj/structure/cable,/obj/structure/disposalpipe/segment{dir = 4},/turf/open/indestructible,/area/deathmatch)
"wL" = (/obj/machinery/conveyor/auto,/obj/item/shard,/obj/structure/disposalpipe/segment{dir = 4},/turf/open/indestructible,/area/deathmatch)
"xa" = (/obj/machinery/conveyor/auto,/obj/structure/disposalpipe/segment{dir = 4},/turf/open/indestructible,/area/deathmatch)
"xg" = (/obj/effect/spawner/structure/window/plasma/reinforced,/obj/structure/disposalpipe/segment{dir = 4},/turf/open/indestructible,/area/deathmatch)
"xj" = (/obj/machinery/conveyor/auto{dir = 1},/obj/structure/disposalpipe/segment{dir = 4},/turf/open/indestructible,/area/deathmatch)
"xs" = (/obj/machinery/conveyor/auto{dir = 1},/obj/item/crowbar/red,/obj/structure/disposalpipe/segment{dir = 4},/turf/open/indestructible,/area/deathmatch)
"xF" = (/obj/structure/disposalpipe/segment{dir = 4},/turf/open/indestructible,/area/deathmatch)
"xN" = (/obj/structure/rack,/obj/item/wrench,/obj/structure/disposalpipe/segment{dir = 4},/turf/open/indestructible,/area/deathmatch)
"xW" = (/obj/structure/reflector/single/mapping{dir = 9},/obj/effect/turf_decal/bot/left,/turf/open/indestructible,/area/deathmatch)
"xY" = (/obj/structure/disposalpipe/segment{dir = 10},/turf/open/indestructible,/area/deathmatch)
"yj" = (/obj/machinery/conveyor/auto{dir = 1},/obj/structure/closet,/obj/item/toy/crayon/spraycan,/turf/open/indestructible,/area/deathmatch)
"ys" = (/obj/structure/disposalpipe/segment{dir = 4},/turf/closed/indestructible/reinforced,/area/deathmatch)
"yB" = (/obj/effect/turf_decal/stripes/line{dir = 4},/obj/structure/disposalpipe/segment{dir = 4},/turf/open/indestructible,/area/deathmatch)
"yR" = (/obj/effect/spawner/structure/window/plasma/reinforced,/obj/machinery/atmospherics/pipe/smart/manifold4w/supply/hidden/layer4{dir = 9},/obj/structure/disposalpipe/segment{dir = 4},/turf/open/indestructible,/area/deathmatch)
"yW" = (/obj/effect/turf_decal/stripes/line{dir = 8},/obj/structure/disposalpipe/segment{dir = 4},/turf/open/indestructible,/area/deathmatch)
"yX" = (/obj/structure/reflector/single/mapping{dir = 5},/obj/effect/turf_decal/bot/left,/obj/structure/disposalpipe/segment{dir = 4},/turf/open/indestructible,/area/deathmatch)
"yY" = (/obj/structure/reflector/single/mapping{dir = 9},/obj/effect/turf_decal/bot/left,/obj/structure/disposalpipe/segment{dir = 1},/turf/open/indestructible,/area/deathmatch)
"zb" = (/obj/structure/table/wood/fancy/black,/obj/item/hemostat/supermatter,/turf/open/indestructible,/area/deathmatch)
"zj" = (/obj/machinery/disposal/delivery_chute,/obj/structure/disposalpipe/trunk{dir = 1},/turf/open/indestructible,/area/deathmatch)
"zl" = (/obj/machinery/button/door/directional/north{id = "deathmatch_shutter_1"; name = "Water Vapour Shutter"},/obj/structure/table/reinforced,/obj/item/clothing/glasses/meson/engine/tray,/turf/open/indestructible,/area/deathmatch)
"zw" = (/obj/item/kirbyplants,/obj/machinery/light/no_nightlight/directional/north,/turf/open/indestructible,/area/deathmatch)
"zL" = (/obj/structure/rack,/obj/item/extinguisher/mini,/turf/open/indestructible,/area/deathmatch)
"Aa" = (/obj/effect/turf_decal/box,/obj/effect/turf_decal/caution/stand_clear,/turf/open/indestructible,/area/deathmatch)
"Am" = (/obj/machinery/door/airlock/engineering/glass{name = "Supermatter Room"},/turf/open/indestructible,/area/deathmatch)
"Ax" = (/obj/structure/cable,/obj/effect/turf_decal/stripes/line{dir = 9},/obj/machinery/atmospherics/components/unary/vent_pump/on/layer4{dir = 1},/turf/open/indestructible,/area/deathmatch)
"AF" = (/obj/structure/cable,/obj/effect/turf_decal/stripes/line{dir = 1},/obj/machinery/atmospherics/components/unary/vent_pump/on/layer4{dir = 1},/turf/open/indestructible,/area/deathmatch)
"AZ" = (/obj/structure/cable,/obj/effect/turf_decal/stripes/line{dir = 5},/obj/machinery/atmospherics/components/unary/vent_pump/on/layer4{dir = 1},/turf/open/indestructible,/area/deathmatch)
"Bf" = (/obj/machinery/power/rad_collector/anchored,/obj/effect/turf_decal/stripes/line{dir = 8},/turf/open/indestructible,/area/deathmatch)
"CC" = (/obj/machinery/vending/engineering,/turf/open/indestructible,/area/deathmatch)
"CH" = (/obj/structure/reflector/single/mapping{dir = 5},/obj/effect/turf_decal/bot/left,/turf/open/indestructible,/area/deathmatch)
"CI" = (/obj/structure/disposalpipe/segment{dir = 1},/turf/open/indestructible,/area/deathmatch)
"CR" = (/obj/machinery/conveyor/auto,/obj/structure/closet/crate,/obj/item/toy/spinningtoy,/turf/open/indestructible,/area/deathmatch)
"Ds" = (/obj/structure/cable,/obj/structure/sign/poster/official/random{pixel_x = 32},/turf/open/indestructible,/area/deathmatch)
"DY" = (/obj/machinery/power/smes/magical,/obj/structure/cable,/turf/open/indestructible,/area/deathmatch)
"Eb" = (/obj/structure/table/wood/fancy/black,/obj/item/nuke_core_container/supermatter,/obj/machinery/light/no_nightlight/directional/west,/turf/open/indestructible,/area/deathmatch)
"Ec" = (/obj/machinery/door/poddoor/shutters/indestructible{id = "deathmatch_shutter_2"},/obj/effect/turf_decal/caution/stand_clear,/obj/effect/turf_decal/bot,/turf/open/indestructible,/area/deathmatch)
"Em" = (/obj/structure/chair/comfy/black,/turf/open/indestructible,/area/deathmatch)
"EY" = (/obj/machinery/door/airlock/engineering/glass{name = "Control Room"; req_access = "100"; req_access_txt = "100"; req_one_access_txt = "10"},/obj/effect/turf_decal/stripes/line{dir = 8},/obj/effect/turf_decal/stripes/line{dir = 4},/turf/open/indestructible,/area/deathmatch)
"Fd" = (/obj/structure/reflector/box/mapping{dir = 4},/obj/effect/turf_decal/stripes/line{dir = 4},/obj/effect/turf_decal/bot,/turf/open/indestructible,/area/deathmatch)
"Fv" = (/obj/machinery/power/supermatter_crystal/shard/hugbox/fakecrystal,/turf/open/indestructible,/area/deathmatch)
"FM" = (/obj/structure/cable,/obj/structure/cable,/obj/effect/turf_decal/stripes/line{dir = 4},/turf/open/indestructible,/area/deathmatch)
"FP" = (/obj/effect/spawner/structure/window/plasma/reinforced,/obj/structure/cable,/turf/open/indestructible,/area/deathmatch)
"FV" = (/obj/structure/cable,/obj/machinery/light/no_nightlight/directional/east,/turf/open/indestructible,/area/deathmatch)
"Gq" = (/obj/structure/cable,/obj/effect/turf_decal/stripes/line{dir = 8},/obj/machinery/light/no_nightlight/directional/west,/turf/open/indestructible,/area/deathmatch)
"Gs" = (/obj/structure/cable,/obj/structure/cable,/obj/effect/landmark/deathmatch_player_spawn,/turf/open/indestructible,/area/deathmatch)
"Gx" = (/obj/machinery/conveyor/auto,/obj/structure/cable,/turf/open/indestructible,/area/deathmatch)
"Gz" = (/obj/machinery/conveyor/auto,/obj/item/multitool,/turf/open/indestructible,/area/deathmatch)
"GB" = (/obj/machinery/conveyor/auto{dir = 1},/obj/item/tank/internals/oxygen,/turf/open/indestructible,/area/deathmatch)
"GH" = (/obj/structure/reflector/single/mapping{dir = 6},/obj/effect/turf_decal/bot/right,/turf/open/indestructible,/area/deathmatch)
"GP" = (/obj/structure/reflector/single/mapping{dir = 10},/obj/effect/turf_decal/bot/right,/turf/open/indestructible,/area/deathmatch)
"GT" = (/obj/structure/cable,/obj/item/clothing/suit/hazardvest,/turf/open/indestructible,/area/deathmatch)
"GV" = (/obj/structure/cable,/turf/closed/indestructible/reinforced,/area/deathmatch)
"Hn" = (/obj/structure/table/wood/fancy/black,/obj/item/scalpel/supermatter,/turf/open/indestructible,/area/deathmatch)
"HL" = (/obj/item/clothing/gloves/color/yellow{desc = "This is it. The only reason of your existence. Grab it, put them on and enjoy your newfound godhood!"},/obj/structure/rack,/turf/open/indestructible,/area/deathmatch)
"HP" = (/obj/machinery/computer/operating{desc = "You start to get the feeling this is the wrong operating console...."; dir = 1},/turf/open/indestructible,/area/deathmatch)
"HY" = (/obj/structure/reflector/single/mapping{dir = 9},/obj/effect/turf_decal/bot/right,/turf/open/indestructible,/area/deathmatch)
"Js" = (/obj/structure/table/reinforced,/obj/item/reagent_containers/pill/patch/aiuri,/turf/open/indestructible,/area/deathmatch)
"JF" = (/obj/structure/cable,/obj/effect/turf_decal/stripes/line{dir = 10},/obj/machinery/atmospherics/components/unary/vent_scrubber/on/layer4,/turf/open/indestructible,/area/deathmatch)
"Kd" = (/obj/structure/cable,/obj/effect/turf_decal/stripes/line,/obj/machinery/atmospherics/components/unary/vent_scrubber/on/layer4,/turf/open/indestructible,/area/deathmatch)
"KY" = (/obj/structure/cable,/obj/effect/turf_decal/stripes/line{dir = 6},/obj/machinery/atmospherics/components/unary/vent_scrubber/on/layer4,/turf/open/indestructible,/area/deathmatch)
"LK" = (/obj/structure/reflector/single/mapping{dir = 10},/obj/effect/turf_decal/bot/right,/obj/structure/disposalpipe/segment{dir = 5},/turf/open/indestructible,/area/deathmatch)
"Mp" = (/obj/structure/disposalpipe/segment{dir = 10},/turf/closed/indestructible/reinforced,/area/deathmatch)
"Mu" = (/obj/structure/cable,/obj/structure/sign/poster/official/random{pixel_x = -32},/turf/open/indestructible,/area/deathmatch)
"My" = (/obj/effect/turf_decal/stripes/line{dir = 4},/turf/open/indestructible,/area/deathmatch)
"MB" = (/obj/effect/spawner/structure/window/plasma/reinforced,/obj/machinery/atmospherics/pipe/smart/manifold4w/scrubbers/hidden/layer2{dir = 4},/turf/open/indestructible,/area/deathmatch)
"MC" = (/obj/effect/turf_decal/stripes/line{dir = 8},/turf/open/indestructible,/area/deathmatch)
"MP" = (/obj/structure/cable,/obj/machinery/power/floodlight,/turf/open/indestructible,/area/deathmatch)
"MV" = (/obj/structure/disposalpipe/trunk{dir = 1},/obj/structure/disposaloutlet,/turf/open/indestructible,/area/deathmatch)
"NJ" = (/obj/structure/disposalpipe/trunk{dir = 1},/obj/machinery/disposal/delivery_chute,/turf/open/indestructible,/area/deathmatch)
"NY" = (/obj/machinery/the_singularitygen,/turf/open/indestructible,/area/deathmatch)
"Pg" = (/obj/machinery/field/generator/anchored,/obj/machinery/light/no_nightlight/directional/north,/turf/open/indestructible,/area/deathmatch)
"Pu" = (/obj/effect/turf_decal/stripes/corner{dir = 4},/turf/open/indestructible,/area/deathmatch)
"Px" = (/obj/effect/turf_decal/stripes/line{dir = 1},/turf/open/indestructible,/area/deathmatch)
"Qm" = (/obj/machinery/power/rad_collector/anchored,/obj/effect/turf_decal/stripes/line{dir = 1},/turf/open/indestructible,/area/deathmatch)
"QA" = (/obj/effect/turf_decal/stripes/corner{dir = 1},/turf/open/indestructible,/area/deathmatch)
"QG" = (/obj/structure/rack,/obj/item/reagent_containers/glass/bucket,/obj/item/pen,/turf/open/indestructible,/area/deathmatch)
"QQ" = (/obj/machinery/door/poddoor/shutters/indestructible{id = "deathmatch_shutter_1"},/obj/effect/turf_decal/caution/stand_clear,/obj/effect/turf_decal/bot,/turf/open/indestructible,/area/deathmatch)
"Rj" = (/obj/machinery/portable_atmospherics/canister/water_vapor{desc = "You monster."},/obj/machinery/button/door/directional/east{id = "deathmatch_shutter_2"; name = "Supermatter Sampling Shutter"},/turf/open/indestructible,/area/deathmatch)
"Rk" = (/obj/effect/mob_spawn/human/corpse/assistant,/turf/open/indestructible,/area/deathmatch)
"Rv" = (/obj/structure/table/reinforced,/obj/item/weldingtool/mini,/turf/open/indestructible,/area/deathmatch)
"RF" = (/obj/machinery/conveyor/auto{dir = 1},/obj/structure/closet/crate,/obj/item/stack/medical/suture{amount = 6},/turf/open/indestructible,/area/deathmatch)
"Sc" = (/obj/structure/reflector/double/mapping{dir = 5},/obj/effect/turf_decal/bot/right,/turf/open/indestructible,/area/deathmatch)
"Si" = (/obj/item/clothing/head/welding,/turf/open/indestructible,/area/deathmatch)
"SR" = (/obj/machinery/conveyor/auto,/obj/item/tank/internals/oxygen,/turf/open/indestructible,/area/deathmatch)
"SW" = (/obj/machinery/conveyor/auto{dir = 1},/obj/structure/closet/cardboard,/obj/item/dualsaber/toy,/turf/open/indestructible,/area/deathmatch)
"Tu" = (/obj/structure/table/reinforced,/obj/item/bodypart/l_arm/robot,/turf/open/indestructible,/area/deathmatch)
"TO" = (/obj/structure/reflector/single/mapping{dir = 5},/obj/effect/turf_decal/bot/right,/turf/open/indestructible,/area/deathmatch)
"TY" = (/obj/structure/cable,/obj/effect/turf_decal/loading_area{dir = 4},/turf/open/indestructible,/area/deathmatch)
"Ue" = (/obj/structure/table/reinforced,/obj/item/clothing/mask/gas/welding/up,/turf/open/indestructible,/area/deathmatch)
"Uu" = (/obj/machinery/conveyor/auto{dir = 1},/obj/structure/closet,/obj/item/pizzabox/meat{desc = "In honor of those who fell during the infamous Pizza Riot."},/turf/open/indestructible,/area/deathmatch)
"Vr" = (/obj/machinery/conveyor/auto{dir = 9; verted = -1},/turf/open/indestructible,/area/deathmatch)
"Vu" = (/obj/machinery/conveyor/auto{dir = 4},/turf/open/indestructible,/area/deathmatch)
"VC" = (/obj/machinery/conveyor/auto{dir = 10; verted = -1},/turf/open/indestructible,/area/deathmatch)
"VG" = (/obj/item/wrench,/turf/open/indestructible,/area/deathmatch)
"WI" = (/obj/effect/landmark/deathmatch_player_spawn,/obj/machinery/conveyor/auto{dir = 9; verted = -1},/turf/open/indestructible,/area/deathmatch)
"Xp" = (/obj/structure/cable,/obj/structure/extinguisher_cabinet/directional/west,/turf/open/indestructible,/area/deathmatch)
"XU" = (/obj/structure/cable,/obj/machinery/conveyor/auto{dir = 9; verted = -1},/turf/open/indestructible,/area/deathmatch)
"Yn" = (/obj/machinery/conveyor/auto{dir = 4},/obj/structure/cable,/turf/open/indestructible,/area/deathmatch)
"Yz" = (/obj/machinery/conveyor/auto{dir = 4},/obj/structure/cable,/obj/item/clothing/glasses/meson/engine/tray,/turf/open/indestructible,/area/deathmatch)
"YJ" = (/obj/structure/cable,/obj/machinery/conveyor/auto{dir = 10; verted = -1},/turf/open/indestructible,/area/deathmatch)
"YU" = (/obj/structure/cable,/obj/structure/extinguisher_cabinet/directional/east,/turf/open/indestructible,/area/deathmatch)
"YW" = (/obj/structure/cable,/obj/machinery/power/terminal{dir = 8},/turf/open/indestructible,/area/deathmatch)
"YY" = (/obj/machinery/light/no_nightlight/directional/south,/obj/effect/turf_decal/stripes/line{dir = 1},/turf/open/indestructible,/area/deathmatch)
"Zi" = (/obj/structure/sign/poster/official/random{pixel_y = -32},/obj/effect/turf_decal/stripes/line{dir = 1},/turf/open/indestructible,/area/deathmatch)
"Zr" = (/obj/item/storage/backpack/duffelbag/syndie/med/medicalbundle,/turf/open/space/basic,/area/template_noop)
"Zz" = (/obj/machinery/power/singularity_beacon/syndicate,/turf/open/space/basic,/area/template_noop)
"ZD" = (/obj/item/storage/toolbox/syndicate,/turf/open/space/basic,/area/template_noop)

(1,1,1) = {"
jejejejejejejejejejejejejejejejejejejejejejejeacaejejejejejejejejejejejejeje
jeaiaiaiaEaEaiaiaiaiaiaiaiaiaiaiaiblblblblblblblaiaiaiaiaiaiaiaiaiaiaiaEaiai
jeaibWcAcAcAcAcAaEcRbldododtdododydododododododododododtdododododoblcRcAfHai
jefNcAcAfVcAgdgoaiaiaigGgNgNgNgNgNgNgUhjhjhjhRiggNgNihgNgNiEiEgNiPaicYgNgNai
jeaicAjfjnjCcAkhblgNgNgNcAcAcAcAkBgNkPlhlulylUmgcAgNmjcAlhmwlumKgNaiaiaigNai
jeaicAcAmOcAcAkhblgNcAcAcAnpcAnVcAgNorkPoTpelUpfcAgNpOcAkPqncAlUqooTrzaigNai
jeaicArLsasbcAbWblspnpcAsxcAcAcAsPgNkPsXoTlUlUcApfsZtacAkPcAqnlUqooTrzGVhUai
jeaitccAcAcAcAcAaEthcAtTcAcAcAcAtUgNkPkPoTublUcAcAgNuvcAkPcAcAlUFVaiaiaigNai
jeaicAcAuYvDvDvGblvKvTwbwdwywdwywIwKwLxaxgxjxsxFxFwKxNxFxaxYcAyjgNaicAgNgNai
aiaiaEerysysysysyswKyBxgyRyRyRxgyWwKxaxaxgxjxjyXxFwKxFxYkPyYcAlUgNaicAgNcAai
aizbcAzjaizlzwzLblgNAaAmAxAFAZoTBfgNkPkPoTlUlUCCCHgNcACICRCIxWlUDsaiDYYWcAai
aiEbcAcAEccAEmcAEYgNFdoTthFvFMFPGqGsGxGzoTGBlUkBGHgNcACIkPCIGPlUGTGVgNgNhUai
aiHncAcAaiHLHPJsblgNAaAmJFKdKYoTBfgNkPkPoTlUlUGHcAgNcACIkPLKxFxjwKysMpaigNai
aiaiaEaiaiaiaiaiaiMuMyoTMBMBMBoTMCgNkPkPoTlUlUcAcAgNMPMVkPcAcAlUgNaiNJaigNai
jeaicAcAcANYPgvGblspPuPxQmPxQmPxQAgNkPkPoTlUlUcAcAgNQGcAorcAcAlUgNQQRjaigNai
jeaicAcAcARkcAcAaEthcAcAcAcAcAcAtUgNkPkPoTublUcAcAgNRvnVkPcAcARFFVaiaiaigNai
jeaiaEaEaiaicAbWblvKSccAcAcASicAsPgNSRkPoTSWlUcAHYsZTucAkPcATOlUqooTrzGVhUai
jejejejejeaicAkhblgNcAnVcASccAcAcATYkPkPoTlUlUHYcAgNUecAkPTOcAUuqooTrzaigNai
jejejejejeaicAkhblgNgNgNkBcAcAcAcATYkPVrVuVClUVGcAgNmjcAWIVuVuVCgNaiaiaigNai
jejejejejeaicAcAaiaiaiXpgNgNgNgNgNgNXUYnYnYzYJgNgNgNgNgNgNigiggNYUaigCgNgNai
jejejejejeaicAcAaEcRblPxPxYYPxPxPxPxPxPxPxPxPxPxPxZiPxYYPxPxPxPxPxblcRcAfHai
jejejejejeaiaEaEaiaiaiaiaiaiaiaiaiblblblblblblblaiaiaiaiaiaiaiaiaiaiaiaEaiai
jejejejejejejejejejejejejejejejejejeZrZzjejeZDjejejejejejejejejejejejejejeje
"}
