"a" = (/turf/template_noop,/area/template_noop)
"b" = (/obj/machinery/power/terminal,/turf/open/floor/plating/airless,/area/deathmatch/fullbright)
"c" = (/obj/structure/cable,/obj/structure/grille,/obj/structure/window/reinforced/spawner/north,/obj/structure/window/reinforced/spawner/west,/turf/open/floor/plating,/area/deathmatch/fullbright)
"d" = (/obj/structure/cable,/obj/machinery/power/smes/magical{output_level = 200000},/turf/open/floor/plating,/area/deathmatch/fullbright)
"f" = (/obj/structure/chair/comfy/shuttle{dir = 4},/turf/open/floor/plating/airless,/area/deathmatch/fullbright)
"k" = (/obj/structure/cable,/obj/structure/window/reinforced/spawner/north,/obj/structure/grille,/turf/open/floor/plating,/area/deathmatch/fullbright)
"l" = (/obj/structure/cable,/obj/structure/grille,/obj/structure/window/reinforced/spawner/north,/turf/open/floor/plating,/area/deathmatch/fullbright)
"m" = (/turf/open/indestructible/deathmatch,/area/deathmatch/fullbright)
"o" = (/obj/structure/grille,/obj/structure/cable,/obj/structure/window/reinforced/spawner/north,/turf/open/floor/plating,/area/deathmatch/fullbright)
"q" = (/obj/structure/grille,/obj/structure/cable,/obj/structure/window/reinforced/spawner/north,/obj/structure/window/reinforced/spawner/east,/turf/open/floor/plating,/area/deathmatch/fullbright)
"w" = (/obj/structure/cable,/obj/structure/grille,/obj/structure/window/reinforced/spawner/east,/turf/open/floor/plating,/area/deathmatch/fullbright)
"A" = (/turf/open/floor/plating,/area/deathmatch/fullbright)
"D" = (/obj/structure/cable,/obj/structure/grille,/obj/structure/window/reinforced/spawner,/turf/open/floor/plating,/area/deathmatch/fullbright)
"F" = (/obj/structure/cable,/obj/structure/grille,/obj/structure/window/reinforced/spawner/west,/turf/open/floor/plating,/area/deathmatch/fullbright)
"G" = (/obj/structure/cable,/obj/structure/grille,/obj/structure/window/reinforced/spawner/east,/obj/structure/window/reinforced/spawner,/turf/open/floor/plating,/area/deathmatch/fullbright)
"I" = (/obj/structure/grille,/obj/structure/cable,/obj/structure/window/reinforced/spawner/east,/turf/open/floor/plating,/area/deathmatch/fullbright)
"K" = (/obj/structure/chair/comfy/shuttle{dir = 8},/turf/open/floor/plating/airless,/area/deathmatch/fullbright)
"Q" = (/obj/effect/landmark/deathmatch_player_spawn,/turf/open/floor/plating,/area/deathmatch/fullbright)
"T" = (/turf/open/floor/plating/airless,/area/deathmatch/fullbright)
"V" = (/obj/structure/cable,/obj/structure/window/reinforced/spawner/west,/obj/structure/grille,/turf/open/floor/plating,/area/deathmatch/fullbright)
"X" = (/obj/structure/cable,/obj/structure/window/reinforced/spawner/west,/obj/structure/window/reinforced/spawner,/obj/structure/grille,/turf/open/floor/plating,/area/deathmatch/fullbright)
"Z" = (/obj/structure/cable,/obj/structure/window/reinforced/spawner,/obj/structure/grille,/turf/open/floor/plating,/area/deathmatch/fullbright)

(1,1,1) = {"
aaaaammmmmmmaaaaa
aaaaammmmmmmaaaaa
mmmmmmmTbTmmmmmmm
mmmmmmmTdTmmmmmmm
mmfcllllklkooqKmm
mmfFAAAAAAAAAIKmm
mmfFAAAAAAAAAwKmm
mmfFAAAAAAAAAwKmm
mmfFAAAAAAAAAwKmm
mmfFAQAAAAAQAwKmm
mmfFAAAAAAAAAwKmm
mmfFAAAAAAAAAwKmm
mmfFAAAAAAAAAwKmm
mmfVAAAAAAAAAwKmm
mmfXZZDDDDDDDGKmm
mmmmmmmmmmmmmmmmm
mmmmmmmmmmmmmmmmm
"}
